10 15
_ _ _ _ _ _ _ _ _ _
_ _ _ _ _ _ _ _ _ _
_ _ _ _ x _ x _ _ _
_ _ _ x _ _ _ _ _ _
_ _ _ x _ _ _ _ _ _
_ _ _ x _ _ _ _ _ _
_ _ _ x _ _ _ _ _ _
_ _ _ x _ _ _ _ _ _
_ _ _ x _ _ _ _ _ _
_ _ _ x _ _ _ _ _ _
_ _ _ x _ _ _ _ _ _
_ P _ x _ _ _ _ _ _
_ _ _ _ _ _ _ _ _ _
_ _ P x _ E _ _ _ _
_ _ _ x _ _ _ _ _ _