10 15
_ _ _ _ _ _ _ _ _ _
_ _ _ _ _ _ _ _ _ _
_ _ _ _ x _ x _ _ _
_ _ _ x _ _ _ _ _ _
_ _ _ x _ _ _ _ _ _
_ _ _ x _ _ _ _ _ _
_ _ _ x _ _ _ _ _ _
_ _ _ x _ _ _ _ _ _
_ _ _ x _ _ _ _ _ _
_ _ _ x _ _ _ _ _ _
_ _ _ x _ _ _ _ _ _
_ 1 _ x _ _ _ _ _ _
_ _ _ _ _ _ _ _ _ _
_ _ 1 x _ 2 _ _ _ _
_ _ _ x _ _ _ _ _ _